Polling Station Number,Conservative,Green Party,Liberal,NDP-New Democratic Party,Vote Totals,Conservative (%),Green Party (%),Liberal (%),NDP-New Democratic Party (%)
1,89,7,6,48,150,59.33,4.67,4.0,32.0
10,115,5,15,52,187,61.5,2.67,8.02,27.81
100,121,12,29,81,243,49.79,4.94,11.93,33.33
101,103,6,19,69,197,52.28,3.05,9.64,35.03
102,74,8,29,53,164,45.12,4.88,17.68,32.32
103,120,10,25,89,244,49.18,4.1,10.25,36.48
104,117,3,39,74,233,50.21,1.29,16.74,31.76
105,125,9,21,70,225,55.56,4.0,9.33,31.11
106,104,9,16,43,172,60.47,5.23,9.3,25.0
107,132,23,25,121,301,43.85,7.64,8.31,40.2
108,86,12,13,49,160,53.75,7.5,8.12,30.63
109,137,13,21,79,250,54.8,5.2,8.4,31.6
11,93,7,18,41,159,58.49,4.4,11.32,25.79
110,62,7,9,56,134,46.27,5.22,6.72,41.79
111,119,4,11,55,189,62.96,2.12,5.82,29.1
112,149,24,36,100,309,48.22,7.77,11.65,32.36
113,169,10,30,84,293,57.68,3.41,10.24,28.67
114,150,14,11,91,266,56.39,5.26,4.14,34.21
115,133,13,19,77,242,54.96,5.37,7.85,31.82
116,81,10,28,61,180,45.0,5.56,15.56,33.89
117,130,11,22,103,266,48.87,4.14,8.27,38.72
118,158,12,26,123,319,49.53,3.76,8.15,38.56
119,102,2,16,94,214,47.66,0.93,7.48,43.93
12,92,8,19,46,165,55.76,4.85,11.52,27.88
120,163,10,19,85,277,58.84,3.61,6.86,30.69
121,104,3,19,52,178,58.43,1.69,10.67,29.21
121-1,81,8,23,39,151,53.64,5.3,15.23,25.83
122,208,11,44,140,403,51.61,2.73,10.92,34.74
123,80,5,23,59,167,47.9,2.99,13.77,35.33
124,80,5,17,29,131,61.07,3.82,12.98,22.14
125,78,4,12,75,169,46.15,2.37,7.1,44.38
126,0,0,0,0,0,,,,
127,84,2,10,37,133,63.16,1.5,7.52,27.82
128,94,6,35,41,176,53.41,3.41,19.89,23.3
128-1,95,4,25,67,191,49.74,2.09,13.09,35.08
129,85,6,18,46,155,54.84,3.87,11.61,29.68
129-1,115,9,26,98,248,46.37,3.63,10.48,39.52
13,89,11,10,60,170,52.35,6.47,5.88,35.29
130,146,10,26,78,260,56.15,3.85,10.0,30.0
131,79,10,22,58,169,46.75,5.92,13.02,34.32
132,100,16,20,39,175,57.14,9.14,11.43,22.29
132-1,97,2,25,37,161,60.25,1.24,15.53,22.98
133,150,4,32,93,279,53.76,1.43,11.47,33.33
134,121,7,30,81,239,50.63,2.93,12.55,33.89
135,155,11,36,74,276,56.16,3.99,13.04,26.81
135-1,156,7,54,65,282,55.32,2.48,19.15,23.05
136,149,8,39,66,262,56.87,3.05,14.89,25.19
137,90,16,32,97,235,38.3,6.81,13.62,41.28
138,142,10,34,69,255,55.69,3.92,13.33,27.06
139,127,11,19,66,223,56.95,4.93,8.52,29.6
14,198,22,24,67,311,63.67,7.07,7.72,21.54
15,162,10,9,41,222,72.97,4.5,4.05,18.47
16,106,11,6,36,159,66.67,6.92,3.77,22.64
17,40,3,4,28,75,53.33,4.0,5.33,37.33
18,154,15,14,63,246,62.6,6.1,5.69,25.61
19,107,11,12,54,184,58.15,5.98,6.52,29.35
2,100,7,21,72,200,50.0,3.5,10.5,36.0
20,93,4,12,32,141,65.96,2.84,8.51,22.7
20-1,99,7,9,68,183,54.1,3.83,4.92,37.16
21,87,4,12,44,147,59.18,2.72,8.16,29.93
22,121,10,24,60,215,56.28,4.65,11.16,27.91
23,77,7,8,29,121,63.64,5.79,6.61,23.97
24,157,3,23,75,258,60.85,1.16,8.91,29.07
25,97,10,9,43,159,61.01,6.29,5.66,27.04
26,141,8,13,45,207,68.12,3.86,6.28,21.74
27,125,16,10,79,230,54.35,6.96,4.35,34.35
28,161,13,21,74,269,59.85,4.83,7.81,27.51
29,125,17,16,47,205,60.98,8.29,7.8,22.93
3,96,2,2,18,118,81.36,1.69,1.69,15.25
30,140,17,4,48,209,66.99,8.13,1.91,22.97
31,100,9,15,57,181,55.25,4.97,8.29,31.49
32,132,5,23,63,223,59.19,2.24,10.31,28.25
33,117,6,32,89,244,47.95,2.46,13.11,36.48
34,167,7,22,117,313,53.35,2.24,7.03,37.38
35,97,8,23,76,204,47.55,3.92,11.27,37.25
36,120,11,35,72,238,50.42,4.62,14.71,30.25
37,135,10,32,70,247,54.66,4.05,12.96,28.34
38,85,9,21,61,176,48.3,5.11,11.93,34.66
39,107,15,33,79,234,45.73,6.41,14.1,33.76
4,86,12,11,31,140,61.43,8.57,7.86,22.14
4-1,133,17,27,49,226,58.85,7.52,11.95,21.68
40,126,6,41,51,224,56.25,2.68,18.3,22.77
40-1,53,10,13,50,126,42.06,7.94,10.32,39.68
41,114,11,18,103,246,46.34,4.47,7.32,41.87
42,102,14,12,96,224,45.54,6.25,5.36,42.86
43,184,13,42,158,397,46.35,3.27,10.58,39.8
44,98,9,16,65,188,52.13,4.79,8.51,34.57
45,125,18,15,47,205,60.98,8.78,7.32,22.93
46,173,18,16,74,281,61.57,6.41,5.69,26.33
47,108,9,22,77,216,50.0,4.17,10.19,35.65
48,123,12,12,56,203,60.59,5.91,5.91,27.59
49,125,13,15,51,204,61.27,6.37,7.35,25.0
5,97,25,9,48,179,54.19,13.97,5.03,26.82
50,82,10,7,33,132,62.12,7.58,5.3,25.0
500,37,6,16,11,70,52.86,8.57,22.86,15.71
501,23,3,8,5,39,58.97,7.69,20.51,12.82
502,27,6,18,13,64,42.19,9.38,28.12,20.31
503,43,2,11,7,63,68.25,3.17,17.46,11.11
51,149,13,11,59,232,64.22,5.6,4.74,25.43
52,117,17,10,50,194,60.31,8.76,5.15,25.77
53,130,5,6,54,195,66.67,2.56,3.08,27.69
54,99,22,20,66,207,47.83,10.63,9.66,31.88
55,90,9,8,19,126,71.43,7.14,6.35,15.08
56,83,12,15,32,142,58.45,8.45,10.56,22.54
57,97,12,14,56,179,54.19,6.7,7.82,31.28
58,104,17,4,31,156,66.67,10.9,2.56,19.87
59,101,10,26,56,193,52.33,5.18,13.47,29.02
6,0,0,0,0,0,,,,
60,96,10,16,35,157,61.15,6.37,10.19,22.29
600,69,10,16,20,115,60.0,8.7,13.91,17.39
601,283,29,38,73,423,66.9,6.86,8.98,17.26
602,396,20,37,101,554,71.48,3.61,6.68,18.23
603,284,19,96,123,522,54.41,3.64,18.39,23.56
604,226,20,70,91,407,55.53,4.91,17.2,22.36
605,191,15,27,30,263,72.62,5.7,10.27,11.41
606,117,17,27,12,173,67.63,9.83,15.61,6.94
607,276,17,49,70,412,66.99,4.13,11.89,16.99
608,368,24,73,55,520,70.77,4.62,14.04,10.58
609,136,7,19,28,190,71.58,3.68,10.0,14.74
61,118,9,18,71,216,54.63,4.17,8.33,32.87
610,201,9,19,53,282,71.28,3.19,6.74,18.79
611,113,5,41,19,178,63.48,2.81,23.03,10.67
612,382,15,83,145,625,61.12,2.4,13.28,23.2
613,148,5,22,46,221,66.97,2.26,9.95,20.81
614,559,31,119,153,862,64.85,3.6,13.81,17.75
615,405,29,110,126,670,60.45,4.33,16.42,18.81
62,150,10,16,45,221,67.87,4.52,7.24,20.36
63,133,10,20,30,193,68.91,5.18,10.36,15.54
64,137,7,17,28,189,72.49,3.7,8.99,14.81
65,122,7,16,51,196,62.24,3.57,8.16,26.02
66,125,7,15,28,175,71.43,4.0,8.57,16.0
67,120,8,12,32,172,69.77,4.65,6.98,18.6
68,132,8,17,81,238,55.46,3.36,7.14,34.03
69,66,11,18,24,119,55.46,9.24,15.13,20.17
7,145,9,15,54,223,65.02,4.04,6.73,24.22
70,71,9,9,34,123,57.72,7.32,7.32,27.64
71,71,9,9,36,125,56.8,7.2,7.2,28.8
72,65,2,3,26,96,67.71,2.08,3.12,27.08
73,105,5,13,69,192,54.69,2.6,6.77,35.94
74,147,8,13,90,258,56.98,3.1,5.04,34.88
75,43,2,5,44,94,45.74,2.13,5.32,46.81
76,127,5,13,51,196,64.8,2.55,6.63,26.02
77,76,10,10,54,150,50.67,6.67,6.67,36.0
78,118,7,9,58,192,61.46,3.65,4.69,30.21
79,40,3,5,13,61,65.57,4.92,8.2,21.31
8,149,17,11,70,247,60.32,6.88,4.45,28.34
80,92,6,12,31,141,65.25,4.26,8.51,21.99
81,85,14,27,31,157,54.14,8.92,17.2,19.75
82,110,3,18,15,146,75.34,2.05,12.33,10.27
83,61,13,11,45,130,46.92,10.0,8.46,34.62
84,79,6,11,28,124,63.71,4.84,8.87,22.58
85,84,7,11,25,127,66.14,5.51,8.66,19.69
86,166,11,29,50,256,64.84,4.3,11.33,19.53
87,108,14,17,35,174,62.07,8.05,9.77,20.11
88,71,11,9,29,120,59.17,9.17,7.5,24.17
89,70,16,14,28,128,54.69,12.5,10.94,21.88
9,91,11,7,31,140,65.0,7.86,5.0,22.14
90,69,6,5,17,97,71.13,6.19,5.15,17.53
91,127,16,30,47,220,57.73,7.27,13.64,21.36
92,125,11,32,82,250,50.0,4.4,12.8,32.8
93,129,13,28,55,225,57.33,5.78,12.44,24.44
94,175,19,28,81,303,57.76,6.27,9.24,26.73
95,134,17,16,77,244,54.92,6.97,6.56,31.56
96,128,11,7,78,224,57.14,4.91,3.12,34.82
97,145,9,15,72,241,60.17,3.73,6.22,29.88
98,106,9,17,70,202,52.48,4.46,8.42,34.65
99,160,7,8,84,259,61.78,2.7,3.09,32.43
S/R 1,96,6,14,17,133,72.18,4.51,10.53,12.78
S/R 2,381,33,91,83,588,64.8,5.61,15.48,14.12
