Polling Station Number,Conservative,Liberal,NDP-New Democratic Party,Vote Totals,Conservative (%),Liberal (%),NDP-New Democratic Party (%)
1,21,27,110,158,13.29,17.09,69.62
10,29,18,160,207,14.01,8.7,77.29
100,28,16,190,234,11.97,6.84,81.2
101,28,32,151,211,13.27,15.17,71.56
102,25,60,168,253,9.88,23.72,66.4
103,17,45,148,210,8.1,21.43,70.48
104,9,57,105,171,5.26,33.33,61.4
105,9,57,94,160,5.62,35.62,58.75
106,25,50,164,239,10.46,20.92,68.62
107,19,26,142,187,10.16,13.9,75.94
108,21,76,122,219,9.59,34.7,55.71
109,22,44,136,202,10.89,21.78,67.33
11,27,39,184,250,10.8,15.6,73.6
110,15,32,105,152,9.87,21.05,69.08
111,23,59,115,197,11.68,29.95,58.38
112,10,28,112,150,6.67,18.67,74.67
113,14,39,128,181,7.73,21.55,70.72
114,11,18,121,150,7.33,12.0,80.67
115,28,34,119,181,15.47,18.78,65.75
116,7,35,135,177,3.95,19.77,76.27
117,43,30,159,232,18.53,12.93,68.53
118,23,14,53,90,25.56,15.56,58.89
119,39,26,119,184,21.2,14.13,64.67
12,33,25,136,194,17.01,12.89,70.1
120,26,8,49,83,31.33,9.64,59.04
121,44,27,180,251,17.53,10.76,71.71
122,15,7,122,144,10.42,4.86,84.72
123,17,17,118,152,11.18,11.18,77.63
124,22,5,104,131,16.79,3.82,79.39
125,10,15,127,152,6.58,9.87,83.55
126,10,9,50,69,14.49,13.04,72.46
127,12,3,110,125,9.6,2.4,88.0
128,15,12,96,123,12.2,9.76,78.05
129,28,9,122,159,17.61,5.66,76.73
13,25,28,156,209,11.96,13.4,74.64
130,14,9,113,136,10.29,6.62,83.09
131,25,17,157,199,12.56,8.54,78.89
132,31,4,122,157,19.75,2.55,77.71
133,23,10,108,141,16.31,7.09,76.6
134,29,4,137,170,17.06,2.35,80.59
135,62,22,135,219,28.31,10.05,61.64
136,14,10,80,104,13.46,9.62,76.92
137,35,18,158,211,16.59,8.53,74.88
138,25,23,88,136,18.38,16.91,64.71
139,30,16,98,144,20.83,11.11,68.06
14,30,37,132,199,15.08,18.59,66.33
140,30,37,124,191,15.71,19.37,64.92
141,23,35,160,218,10.55,16.06,73.39
142,14,21,92,127,11.02,16.54,72.44
143,35,22,72,129,27.13,17.05,55.81
144,27,26,83,136,19.85,19.12,61.03
145,32,8,74,114,28.07,7.02,64.91
146,12,10,148,170,7.06,5.88,87.06
147,13,11,101,125,10.4,8.8,80.8
148,13,12,121,146,8.9,8.22,82.88
149,21,29,135,185,11.35,15.68,72.97
15,32,32,157,221,14.48,14.48,71.04
150,23,32,223,278,8.27,11.51,80.22
151,15,9,116,140,10.71,6.43,82.86
152,8,9,144,161,4.97,5.59,89.44
153,44,22,156,222,19.82,9.91,70.27
154,63,31,85,179,35.2,17.32,47.49
155,22,12,100,134,16.42,8.96,74.63
156,22,23,140,185,11.89,12.43,75.68
157,26,21,149,196,13.27,10.71,76.02
158,26,35,202,263,9.89,13.31,76.81
159,16,20,183,219,7.31,9.13,83.56
16,19,20,114,153,12.42,13.07,74.51
160,21,32,177,230,9.13,13.91,76.96
161,13,22,289,324,4.01,6.79,89.2
162,8,10,89,107,7.48,9.35,83.18
163,14,36,106,156,8.97,23.08,67.95
164,11,24,179,214,5.14,11.21,83.64
165,10,15,189,214,4.67,7.01,88.32
166,27,20,132,179,15.08,11.17,73.74
167,7,18,105,130,5.38,13.85,80.77
168,3,21,82,106,2.83,19.81,77.36
169,6,28,90,124,4.84,22.58,72.58
17,35,17,147,199,17.59,8.54,73.87
170,4,4,59,67,5.97,5.97,88.06
171,18,29,145,192,9.38,15.1,75.52
172,11,19,109,139,7.91,13.67,78.42
173,37,33,133,203,18.23,16.26,65.52
174,17,30,185,232,7.33,12.93,79.74
175,17,27,168,212,8.02,12.74,79.25
176,24,18,179,221,10.86,8.14,81.0
177,29,23,137,189,15.34,12.17,72.49
178,25,36,171,232,10.78,15.52,73.71
179,19,26,182,227,8.37,11.45,80.18
18,30,20,161,211,14.22,9.48,76.3
180,17,15,114,146,11.64,10.27,78.08
181,23,31,130,184,12.5,16.85,70.65
182,17,46,230,293,5.8,15.7,78.5
183,21,23,146,190,11.05,12.11,76.84
184,28,20,168,216,12.96,9.26,77.78
185,29,13,118,160,18.12,8.12,73.75
186,17,29,143,189,8.99,15.34,75.66
187,45,37,193,275,16.36,13.45,70.18
188,32,31,184,247,12.96,12.55,74.49
189,13,10,160,183,7.1,5.46,87.43
189-1,22,15,123,160,13.75,9.38,76.88
19,29,19,138,186,15.59,10.22,74.19
190,22,21,181,224,9.82,9.38,80.8
191,22,29,117,168,13.1,17.26,69.64
192,34,27,106,167,20.36,16.17,63.47
193,33,28,115,176,18.75,15.91,65.34
194,16,19,92,127,12.6,14.96,72.44
195,33,24,130,187,17.65,12.83,69.52
196,20,21,124,165,12.12,12.73,75.15
197,36,23,135,194,18.56,11.86,69.59
198,43,25,175,243,17.7,10.29,72.02
199,40,38,190,268,14.93,14.18,70.9
2,24,15,133,172,13.95,8.72,77.33
20,29,29,158,216,13.43,13.43,73.15
200,23,38,191,252,9.13,15.08,75.79
201,50,38,151,239,20.92,15.9,63.18
21,30,19,171,220,13.64,8.64,77.73
22,34,14,137,185,18.38,7.57,74.05
23,37,21,214,272,13.6,7.72,78.68
24,42,20,160,222,18.92,9.01,72.07
25,36,38,176,250,14.4,15.2,70.4
26,27,28,116,171,15.79,16.37,67.84
27,10,23,67,100,10.0,23.0,67.0
28,24,25,134,183,13.11,13.66,73.22
29,28,37,126,191,14.66,19.37,65.97
3,14,19,138,171,8.19,11.11,80.7
30,33,17,91,141,23.4,12.06,64.54
31,38,26,139,203,18.72,12.81,68.47
32,29,25,113,167,17.37,14.97,67.66
33,38,41,152,231,16.45,17.75,65.8
34,41,21,114,176,23.3,11.93,64.77
35,57,34,110,201,28.36,16.92,54.73
36,60,32,94,186,32.26,17.2,50.54
37,24,20,103,147,16.33,13.61,70.07
38,23,20,91,134,17.16,14.93,67.91
39,34,17,82,133,25.56,12.78,61.65
4,21,17,148,186,11.29,9.14,79.57
40,36,12,114,162,22.22,7.41,70.37
41,45,14,96,155,29.03,9.03,61.94
42,29,22,87,138,21.01,15.94,63.04
43,19,18,110,147,12.93,12.24,74.83
44,49,31,98,178,27.53,17.42,55.06
45,21,17,105,143,14.69,11.89,73.43
46,12,4,63,79,15.19,5.06,79.75
47,18,15,72,105,17.14,14.29,68.57
48,26,19,72,117,22.22,16.24,61.54
49,17,6,61,84,20.24,7.14,72.62
5,28,17,181,226,12.39,7.52,80.09
50,14,9,65,88,15.91,10.23,73.86
500,7,25,35,67,10.45,37.31,52.24
501,24,43,65,132,18.18,32.58,49.24
502,5,24,31,60,8.33,40.0,51.67
503,10,17,28,55,18.18,30.91,50.91
504,16,21,30,67,23.88,31.34,44.78
505,12,17,37,66,18.18,25.76,56.06
506,15,36,34,85,17.65,42.35,40.0
507,23,15,29,67,34.33,22.39,43.28
508,15,7,58,80,18.75,8.75,72.5
509,7,11,30,48,14.58,22.92,62.5
51,11,7,54,72,15.28,9.72,75.0
510,16,25,40,81,19.75,30.86,49.38
511,11,15,20,46,23.91,32.61,43.48
512,12,19,51,82,14.63,23.17,62.2
513,4,16,29,49,8.16,32.65,59.18
514,6,6,19,31,19.35,19.35,61.29
515,9,6,32,47,19.15,12.77,68.09
516,14,28,29,71,19.72,39.44,40.85
517,17,33,35,85,20.0,38.82,41.18
518,13,13,32,58,22.41,22.41,55.17
52,41,16,96,153,26.8,10.46,62.75
53,65,39,76,180,36.11,21.67,42.22
54,38,19,52,109,34.86,17.43,47.71
55,27,11,75,113,23.89,9.73,66.37
56,13,10,69,92,14.13,10.87,75.0
57,25,14,76,115,21.74,12.17,66.09
58,16,16,46,78,20.51,20.51,58.97
59,15,19,59,93,16.13,20.43,63.44
6,17,14,131,162,10.49,8.64,80.86
60,13,16,38,67,19.4,23.88,56.72
600,74,85,256,415,17.83,20.48,61.69
601,44,38,140,222,19.82,17.12,63.06
602,95,74,304,473,20.08,15.64,64.27
603,132,117,261,510,25.88,22.94,51.18
604,132,97,245,474,27.85,20.46,51.69
605,166,83,282,531,31.26,15.63,53.11
606,50,19,74,143,34.97,13.29,51.75
607,66,17,147,230,28.7,7.39,63.91
608,29,50,247,326,8.9,15.34,75.77
609,79,106,466,651,12.14,16.28,71.58
61,22,12,98,132,16.67,9.09,74.24
610,73,166,339,578,12.63,28.72,58.65
611,57,58,303,418,13.64,13.88,72.49
612,76,74,391,541,14.05,13.68,72.27
613,122,125,530,777,15.7,16.09,68.21
614,47,70,382,499,9.42,14.03,76.55
615,108,67,346,521,20.73,12.86,66.41
616,121,87,404,612,19.77,14.22,66.01
617,28,8,53,89,31.46,8.99,59.55
618,44,116,329,489,9.0,23.72,67.28
62,60,16,87,163,36.81,9.82,53.37
63,30,15,70,115,26.09,13.04,60.87
64,30,12,103,145,20.69,8.28,71.03
65,44,17,109,170,25.88,10.0,64.12
66,31,19,99,149,20.81,12.75,66.44
67,81,9,80,170,47.65,5.29,47.06
68,25,11,79,115,21.74,9.57,68.7
69,73,17,108,198,36.87,8.59,54.55
7,21,18,114,153,13.73,11.76,74.51
70,46,9,75,130,35.38,6.92,57.69
71,62,20,98,180,34.44,11.11,54.44
72,37,19,163,219,16.89,8.68,74.43
73,31,18,95,144,21.53,12.5,65.97
74,48,6,105,159,30.19,3.77,66.04
75,40,31,162,233,17.17,13.3,69.53
76,44,20,153,217,20.28,9.22,70.51
77,49,13,121,183,26.78,7.1,66.12
78,0,0,0,0,,,
79,87,24,194,305,28.52,7.87,63.61
8,40,28,154,222,18.02,12.61,69.37
80,15,15,75,105,14.29,14.29,71.43
81,7,11,75,93,7.53,11.83,80.65
82,32,7,115,154,20.78,4.55,74.68
83,45,9,95,149,30.2,6.04,63.76
84,47,16,181,244,19.26,6.56,74.18
85,32,15,144,191,16.75,7.85,75.39
86,33,13,201,247,13.36,5.26,81.38
87,12,7,86,105,11.43,6.67,81.9
88,93,5,100,198,46.97,2.53,50.51
89,61,21,53,135,45.19,15.56,39.26
9,20,26,141,187,10.7,13.9,75.4
90,6,6,84,96,6.25,6.25,87.5
91,23,20,163,206,11.17,9.71,79.13
92,17,23,136,176,9.66,13.07,77.27
93,14,17,125,156,8.97,10.9,80.13
94,12,27,165,204,5.88,13.24,80.88
95,16,17,119,152,10.53,11.18,78.29
96,8,11,120,139,5.76,7.91,86.33
97,13,19,148,180,7.22,10.56,82.22
98,21,31,171,223,9.42,13.9,76.68
99,24,26,177,227,10.57,11.45,77.97
S/R 1,56,24,58,138,40.58,17.39,42.03
S/R 2,186,232,657,1075,17.3,21.58,61.12
